Singing songs about her, dreaming of her, thinking about how you've finally found the one.  But you're just so nervous about telling her, you've promised yourself that you will tell her one day.  Victoria, her sweet smile and that one of a kind laugh.  You guys send mail to each other all the time.  But with her being a terrible writer, you always find yourself deciphering what her riddles and sketches mean.  Who knows, maybe you've recieved another one today!  You haven't checked your mailbox out in the lawn yet.

Love is in the Air
An Interactive Fiction by Rachel Lee
Release 1 / Serial number 170226 / Inform 7 build 6M62 (I6/v6.33 lib 6/12N) SD

Bathroom
Squeaky clean, just how I like it.  The west hallway is just out the door to the north.

You can see bathroom door, sink, bathtub and toilet here.

I beg your pardon?

* * *

>flush
I didn't understand that sentence.

>flush toilet
CLUNK! Lots of old toilet paper start to bubble up to the surface, and right under them is a golden key.

* * *

>flush toilet
CLUNK! Lots of old toilet paper start to bubble up to the surface, and right under them is a golden key.

>take golden key
You can't see any such thing.

>take key
Taken.

* * *

>h
That's not a verb I recognise.

>e
You can't go that way.

>n
(first opening Bathroom door)
It seems to be locked.

* * *

>n
(first opening bathroom door)
It seems to be locked.

>take key
Taken.

>n
(first opening bathroom door)
It seems to be locked.

>s
You can't go that way.

>e
You can't go that way.

>n
(first opening bathroom door)
It seems to be locked.

>unlock door
(with the gold key)
You unlock bathroom door.

>n
(first opening bathroom door)

West Hallway
The bathroom is to the south, the bedroom is to the west, and the east hallway is just to the east.

You can see bathroom door here.

>e
East Hallway
The living room is to the east, the west hallway is to the west.

>e
Living Room
A typical living room and a wide window on the east wall.  The lawn is to the north through the front door, and the east hallway is just to the west.

You can see a Front Door here.

>x window
You see nothing special about square window.

* * *

>n
(first opening bathroom door)
It seems to be locked.

>x door
Are you kidding me....I've locked myself in..in my own bathroom. I know I left the key in here somewhere, I just need to find it.

* * *

>open door
It seems to be locked.

>x door
Are you kidding me....I've locked myself in..in my own bathroom. I know I left the key in here somewhere, I just need to find it

* * *

>take all
There are none at all available!

>take key
Taken.

>n
(first opening Bathroom door)
It seems to be locked.

>unlcok bathroom door
That's not a verb I recognise.

>unlock bathroom door
(with the gold key)
You unlock Bathroom door.

>n
(first opening Bathroom door)

West Hallway
The bathroom is to the south, the bedroom is to the west, and the east hallway is just to the east.

You can see Bathroom door here.

>w
Bedroom
I don't really have much in my room.  I just have my bed, a study desk, and my bookshelf.  The west hallway is just to the east.

You can see Bed here.

>n
Closet
You can see Black tuxedo here.

>n
You can't go that way.

>open hidden door
You open Hidden door.

>n
You can't go that way.

* * *

>take all
There are none at all available!

>x toilet
I should really fix this toilet, it's been clogged for a while.

>flush toilet
CLUNK! Lots of old toilet paper start to bubble up to the surface, and right under them is a golden key.

>flush
CLUNK! Lots of old toilet paper start to bubble up to the surface, and right under them is a golden key.

* * *

>take bathrub
You can't see any such thing.

>take bathtub
That's fixed in place.

* * *

>take key
Taken.

* * *

>n
(first opening bathroom door)
It seems to be locked.

>unlock door
(with the gold key)
Now I can finally go check my mailbox out on my lawn

>n
Hallway
There's a small window on the north wall.  The living room is to the east, the bathroom is to the south, and the bedroom is to the west.

You can see bathroom door here.

>s
Bathroom
Squeaky clean, just how I like it.  The west hallway is just out the door to the north.

You can see Bathroom door, sink, bathtub and toilet here.

>n
West Hallway
The bathroom is to the south, the bedroom is to the west, and the east hallway is just to the east.

You can see Bathroom door here.

>w
Bedroom
I don't really have much in my room.  I just have my bed, a study desk, and my bookshelf.  The west hallway is just to the east.

>x bookshelf
A couple of books stacked together on the shelf

* * *

>n
Hallway
There's a small window on the north wall.  The living room is to the east, the bathroom is to the south, and the bedroom is to the west.

You can see bathroom door here.

>w
Bedroom
I don't really have much in my room.  I just have my bed, a study desk, and my bookshelf.  There's a wide window above the doors to my closet on the south wall.  The west hallway is just to the east.

>x bookshelf
A couple of books stacked together, and Victoria's favourite book, The Maze Runner

>x the maze runner
She sent me this book through the mail along with a letter, that's how I knew it was her favourite book.  I still never got a chance to open it though.

* * *

>w
Bedroom
I don't really have much in my room.  I just have my bed, a study desk, and my bookshelf.  There's a wide window above the doors to my closet on the south wall.  The west hallway is just to the east.

>x window
You must supply a noun.

* * *

>n
Hallway
There's a small window on the north wall.  The living room is to the east, the bathroom is to the south, and the bedroom is to the west.

You can see bathroom door here.

>x window
I see a cat, the road, and a patch of grass

>e
Living Room
A typical living room and a square window on the east wall.  The lawn is to the north through the front door, and the east hallway is just to the west.

You can see a Front Door and Clock here.

* * *

>n
(first opening bathroom door)
It seems to be locked.

>w
You can't go that way.

>n
(first opening bathroom door)
It seems to be locked.

* * *

>n
(first opening bathroom door)

West Hallway
The bathroom is to the south, the bedroom is to the west, and the east hallway is just to the east.

You can see bathroom door here.

>w
Bedroom
I don't really have much in my room.  I just have my bed, a study desk, and my bookshelf.  There's a wide window above the doors to my closet.  The west hallway is just to the east.

You can see Bed here.

>x book shelf
I only understood you as far as wanting to examine the Maze Runner Book.

>x bookshelf
A couple of books stacked together, and Victoria's favourite book, The Maze Runner

>x the maze runner
She sent me this book through the mail along with a letter, that's how I knew it was her favourite book.  I still never got a chance to open it thought.

* * *

>take key
Taken.

>s
You can't go that way.

>take key
You already have that.

>n
(first opening bathroom door)
It seems to be locked.

* * *

>e
Living Room
A typical living room and a wide window on the east wall.  The lawn is to the north through the front door, and the east hallway is just to the west.

You can see a Front Door here.

>x window
There are a couple small houses, and some trees

* * *

>take key
Taken.

>unlock bathroom
(with the gold key)
You unlock Bathroom door.

* * *

>take key
Taken.

>unlock bathroom door
(with the gold key)
You unlock bathroom door.

>n
(first opening bathroom door)
Now I can finally go check my mailbox out on my lawn
Hallway
There's a small window on the north wall.  The bathroom is to the south, the bedroom is to the west, and the east hallway is just to the east.

You can see bathroom door here.

* * *

>take key
Taken.

>unlock door
(with the gold key)
Now I can finally go check my mailbox out on my lawn

* * *

>n
Hallway
There's a small window on the north wall.  The living room is to the east, the bathroom is to the south, and the bedroom is to the west.

You can see bathroom door here.

>e
Living Room
A typical living room and a square window on the east wall.  The lawn is to the north through the front door, and the east hallway is just to the west.

You can see a Front Door and Clock here.

>e
Living Room
A typical living room and a wide window on the east wall.  The lawn is to the north through the front door, and the east hallway is just to the west.

You can see a Front Door here.

>n
(first opening the Front Door)

Lawn
The sweet smell of roses drifts through the air.  The living room is just to the south through the front door.

You can see a Front Door, Mailbox and Roses here.

>m
That's not a verb I recognise.

>l
Lawn
The sweet smell of roses drifts through the air.  The living room is just to the south through the front door.

You can see a Front Door, Mailbox and Roses here.

>x mailbox
My favourite part of the day, checking my mailbox to see if Victoria sent me another little sketch.

Oh theres a folded piece of paper here.

>x paper
There's a light V.L. sketched on the corner of the paper.  This must be from Victoria.

>open paper
It isn't something you can open.

* * *

>n
(first opening the Front Door)

Lawn
The sweet smell of roses drifts through the air.  The living room is just to the south through the front door.

You can see a Front Door, Mailbox and Roses here.

>x mailbox
My favourite part of the day, checking my mailbox to see if Victoria sent me another little sketch.

Oh theres a folded piece of paper here.

>x mailbox
My favourite part of the day, checking my mailbox to see if Victoria sent me another little sketch.

* * *

>x paper
There's a light V.L. sketched on the corner of the paper.  This must be from Victoria.

>unfold paper
I see a sketch of a wedding arch, two rings, and a heart between two people.  There's also a date and time scribbled on the corner.  August 25 2:00PM.  And theres another little sketch of what looks like a view from a window, there are trees, and part of a church?

>x roses
You see nothing special about Roses.

>pick roses
I didn't understand that sentence.

* * *

>n
(first opening the Front Door)

Lawn
The sweet smell of roses drifts through the air.  The living room is just to the south through the front door.

You can see a Front Door, Mailbox and Roses here.

>x roses
Victoria has always liked roses.

>take roses
They haven't bloomed yet!

>x mailbox
My favourite part of the day, checking my mailbox to see if Victoria sent me another little sketch.

Oh theres a folded piece of paper here.

>take paper
Taken.

>open paper
I see a sketch of a wedding arch, two rings, and a heart between two people.  Is she getting married? There's also a date and time scribbled on the corner.  August 25 2:00PM.  And theres another little sketch of what looks like a view from a window, there are trees, and part of a white building with a bell at the top with arrows pointing at it.

I beg your pardon?

>n
You can't go that way.

>e
You can't go that way.

>s
Living Room
A typical living room and a wide window on the east wall.  The lawn is to the north through the front door, and the east hallway is just to the west.

You can see a Front Door here.

>s
You can't go that way.

* * *

>e
You can't go that way.

>w
East Hallway
The living room is to the east, the west hallway is to the west.

>w
West Hallway
The bathroom is to the south, the bedroom is to the west, and the east hallway is just to the east.

You can see bathroom door here.

>w
Bedroom
I don't really have much in my room.  I just have my bed, a study desk, and my bookshelf.  There's a wide window above the doors to my closet.  The west hallway is just to the east.

You can see Bed and Silver key here.

* * *

>e
Living Room
A typical living room and a square window on the east wall.  The lawn is to the north through the front door, and the east hallway is just to the west.

You can see a Front Door and Clock here.

>n
You can't go that way.

>e
Living Room
The lawn is to the north through the front door, and the east hallway is just to the west.

You can see a Front Door here.

>n
(first opening the Front Door)

Lawn
The sweet smell of roses drifts through the air.  The living room is just to the south through the front door.

You can see a Front Door, Mailbox and Roses here.

>x mailbox
My favourite part of the day, checking my mailbox to see if Victoria sent me another little sketch.

Oh theres a folded piece of paper here.  I wonder what this is.  Maybe it's from Victoria!

>x mailbox
My favourite part of the day, checking my mailbox to see if Victoria sent me another little sketch.

* * *

>e
Living Room
A typical living room and a square window on the east wall.  The lawn is to the north through the front door, and the east hallway is just to the west.

You can see a Front Door and Clock here.

>w
Hallway
There's a small window on the north wall.  The living room is to the east, the bathroom is to the south, and the bedroom is to the west.

You can see bathroom door here.

>w
Bedroom
I don't really have much in my room.  I just have my bed, a study desk, and my bookshelf.  There's a wide window above the doors to my closet on the south wall.  The west hallway is just to the east.

>x window
You see nothing special about wide window.

* * *

>n
Hallway
There's a small window on the north wall.  The living room is to the east, the bathroom is to the south, and the bedroom is to the west.

You can see bathroom door here.

>s
Bathroom
Squeaky clean, just how I like it.  The west hallway is just out the door to the north.

You can see bathroom door, sink, bathtub and toilet here.

>n
West Hallway
The bathroom is to the south, the bedroom is to the west, and the east hallway is just to the east.

You can see bathroom door here.

>e
East Hallway
The living room is to the east, the west hallway is to the west.

>e
Living Room
The lawn is to the north through the front door, and the east hallway is just to the west.

You can see a Front Door here.

* * *

>x mailbox
My favourite part of the day, checking my mailbox to see if Victoria sent me another little sketch.

Oh theres a folded piece of paper here.

>x paper
You see nothing special about Folded piece of paper.

There's a light V.L. sketched on the corner of the paper.  This must be from Victoria.

* * *

>w
Bedroom
I don't really have much in my room.  I just have my bed, a study desk, and my bookshelf.  There's a wide window above the doors to my closet on the south wall.  The west hallway is just to the east.

>x bed
You see nothing special about bed.

>get into bed
I just came out of bed not so long ago!

>x bookshelf
A couple of books stacked together, and Victoria's favourite book, The Maze Runner

>x maze runner
She sent me this book through the mail along with a letter, that's how I knew it was her favourite book.  I still never got a chance to open and and ready it though.

>open maze runner
It turns out to be a hollowed out book...and there's a mysterious silver key inside..

>x silver key
Looks like an antique key with some nice engravings on it.  Wonder what it's for.

>x take key
You can't see any such thing.

>take key
(the gold key)
You already have that.

>take silver key
Taken.

>n
You can't go that way.

>s
Closet
I have stacks of clothes in here, nothing really I want to get into.  My bedroom is to the south.

You can see Black tuxedo here.

>x black tuxedo
You see nothing special about Black tuxedo.

>take black tuxedo
Taken.

>wear black tuxedo
After you've slipped on the jacket to the tuxedo, you look back into the closet where the tuxedo used to be, and see a doorknob.  You push the other clothes away and discover a hidden door.

>wear black tuxedo
You're already wearing that!

>x hidden door
Woah, it's a hidden door.  Nothing really special about it though, looks like just a door with a silver doorknob that has some engravings on it.

>unlock door
What do you want to unlock Hidden door with?

>silver key
You unlock Hidden door.

>s
You can't go that way.

>n
Bedroom
I don't really have much in my room.  I just have my bed, a study desk, and my bookshelf.  There's a wide window above the doors to my closet on the south wall.  The west hallway is just to the east.

>s
Closet
I have stacks of clothes in here, nothing really I want to get into.  My bedroom is to the south.

>open hidden door
After opening the hidden door, you see stairs leading down into the darkness.

>down
Underground tunnel
It is pitch dark, and you can't see a thing.  But you can hear something...

>l
Underground tunnel
It is pitch dark, and you can't see a thing.  But you can hear something...

>l
Underground tunnel
It is pitch dark, and you can't see a thing.  But you can hear something...

>listen
WOOF WOOF! That sounds a lot like Victoria's dog, Chewy!

>n
Darkness
It is pitch dark, and you can't see a thing.

>e
You can't go that way.

>n
You can't go that way.

>s
Underground tunnel
It is pitch dark, and you can't see a thing.  But you can hear something...

>n
Darkness
It is pitch dark, and you can't see a thing.

>w
You can't go that way.

>e
You can't go that way.

* * *

>n
Darkness
It is pitch dark, and you can't see a thing.

>s
Underground tunnel
It is pitch dark, and you can't see a thing.  But you can hear something...

>l
Underground tunnel
It is pitch dark, and you can't see a thing.  But you can hear something...

* * *

>s
Underground tunnel
It is pitch dark, and you can't see a thing.  But you can hear something...

>s
Darkness
It is pitch dark, and you can't see a thing.

>n
That's where you just came from

>n
That's where you just came from

>listen
WOOF! Sounds like it's getting closer!

>n
That's where you just came from

>s
You can't go that way.

>s
You can't go that way.

>listen
WOOF! Sounds like it's getting closer!

>e
Darkness
It is pitch dark, and you can't see a thing.

>north
Darkness
It is pitch dark, and you can't see a thing.

>listen
WOOF! It's even louder!

>east
Darkness
It is pitch dark, and you can't see a thing.

>listen
I can hear the bell on Chewy's collar! This is definitely the right direction

>e
Darkness
It is pitch dark, and you can't see a thing.

>n
East side of underground tunnel
As you approach Chewy, she runs up the stairs.

>up
Back room of a church
A fancy old wooden table with some candles on it.

You can see wooden door here.

>x table
You see a couple lit candles on the table, nothing much.

>open door
As you open the door, there she is.  The love of your life standing right before you, in her gorgeous wedding gown.  All you need to do is go in kiss her.

>kiss her
I'm not sure what 'her' refers to.

>kiss Victoria
You can't see any such thing.

>kiss Victoria
You can't see any such thing.

>n
You can't go that way.

>e
Changing room
You can see wooden door and Victoria here.

>kiss victoria
    *** You always knew you two were meant to be. ***

Would you like to RESTART, RESTORE a saved game, QUIT or UNDO the last command?

>restart
Singing songs about her, dreaming of her, thinking about how you've finally found the one.  But you're just so nervous about telling her, but I've promised myself I will tell her one day.  Victoria, her sweet smile and that one of a kind laugh.  You guys send mail to each other all the time.  But with her being a terrible writer, I always find myself deciphering what her riddles and sketches mean.  Who knows, maybe I've recieved another one today!  I haven't checked my mailbox yet.

Love is in the Air
An Interactive Fiction by Rachel Lee
Release 1 / Serial number 170222 / Inform 7 build 6M62 (I6/v6.33 lib 6/12N) SD

Bathroom
Squeaky clean, just how I like it.  The west hallway is just out the door to the north.

You can see bathroom door, sink, bathtub and toilet here.

>take key
Taken.

>unlock door
(with the gold key)
You unlock bathroom door.

>n
(first opening bathroom door)

Hallway
There's a small window on the north wall.  The bathroom is to the south, the bedroom is to the west, and the east hallway is just to the east.

You can see bathroom door here.

>w
Bedroom
I don't really have much in my room.  I just have my bed, a study desk, and my bookshelf.  There's a wide window above the doors to my closet on the south wall.  The west hallway is just to the east.

>s
Closet
I have stacks of clothes in here, nothing really I want to get into.  My bedroom is to the south.

You can see Black tuxedo here.

>n
Bedroom
I don't really have much in my room.  I just have my bed, a study desk, and my bookshelf.  There's a wide window above the doors to my closet on the south wall.  The west hallway is just to the east.

>e
Hallway
There's a small window on the north wall.  The bathroom is to the south, the bedroom is to the west, and the east hallway is just to the east.

You can see bathroom door here.

>e
Living Room
A typical living room and a square window on the east wall.  The lawn is to the north through the front door, and the east hallway is just to the west.

You can see a Front Door here.

>n
(first opening the Front Door)

Lawn
The sweet smell of roses drifts through the air.  The living room is just to the south through the front door.

You can see a Front Door, Mailbox and Roses here.

>take paper
Taken.

>n
You can't go that way.

>s
Living Room
A typical living room and a square window on the east wall.  The lawn is to the north through the front door, and the east hallway is just to the west.

You can see a Front Door here.

>w
Hallway
There's a small window on the north wall.  The bathroom is to the south, the bedroom is to the west, and the east hallway is just to the east.

You can see bathroom door here.

>w
Bedroom
I don't really have much in my room.  I just have my bed, a study desk, and my bookshelf.  There's a wide window above the doors to my closet on the south wall.  The west hallway is just to the east.

>take silver key
Taken.

* * *

>s
Closet
I have stacks of clothes in here, nothing really I want to get into.  My bedroom is to the south.

You can see Black tuxedo here.

>unlock hidden door
What do you want to unlock Hidden door with?

>silver key
You unlock Hidden door.

>n
Bedroom
I don't really have much in my room.  I just have my bed, a study desk, and my bookshelf.  There's a wide window above the doors to my closet on the south wall.  The west hallway is just to the east.

>s
Closet
I have stacks of clothes in here, nothing really I want to get into.  My bedroom is to the south.

You can see Black tuxedo here.

>s
You can't go that way.

* * *

>e
You can't go that way.

>down
Underground tunnel
It is pitch dark, and you can't see a thing.  But you can hear something...

>listen
WOOF WOOF! That sounds a lot like Victoria's dog, Chewy!

* * *

>e
You can't go that way.

>s
Underground tunnel
It is pitch dark, and you can't see a thing.  But you can hear something...

>listen
WOOF WOOF! That sounds a lot like Victoria's dog, Chewy!

>e
You can't go that way.

>e
You can't go that way.

>n
Darkness
It is pitch dark, and you can't see a thing.

* * *

>n
You can't go that way.

>up
You can't go that way.

>open wooden door
You can't see any such thing.

>n
You can't go that way.

* * *

>e
You can't go that way.

>kiss victoria
You can't see any such thing.

>restore
Restore failed.

>undo
Darkness
[Previous turn undone.]

>n
You can't go that way.

* * *

>s
Underground tunnel
It is pitch dark, and you can't see a thing.  But you can hear something...

>e
You can't go that way.

>w
You can't go that way.

>down
You can't go that way.

>n
Darkness
It is pitch dark, and you can't see a thing.

* * *

>s
Underground tunnel
It is pitch dark, and you can't see a thing.  But you can hear something...

>w
You can't go that way.

* * *

>x the maze runner
She sent me this book through the mail along with a letter, that's how I knew it was her favourite book.  I still never got a chance to open it though.

>open book
It isn't something you can open.

* * *

>x window
I see a cat, the road, and a patch of grass

>w
Bedroom
I don't really have much in my room.  I just have my bed, a study desk, and my bookshelf.  There's a wide window above the doors to my closet on the south wall.  The west hallway is just to the east.

>x window
I see a some trees, and a white building with a bell on it.

* * *

>unlock door
(with the gold key)
Now I can finally go check my mailbox out on my lawn

>w
You can't go that way.

>n
(first opening Bathroom door)

West Hallway
The bathroom is to the south, the bedroom is to the west, and the east hallway is just to the east.

You can see Bathroom door here.

* * *

>w
Bedroom
I don't really have much in my room.  I just have my bed, a study desk, and my bookshelf.  The west hallway is just to the east.

You can see Bed here.

>s
You can't go that way.

>n
Closet
You can see Hidden door and Black tuxedo here.

>n
(first opening Hidden door)

Underground tunnel
You can see Hidden door here.

>w
West side of underground tunnel

>up
Back room of a church

* * *

>west
You can't go that way.

>south
You can't go that way.

>east
You can't go that way.

>northwest
You can't go that way.

>hi
That's not a verb I recognise.

>no
That was a rhetorical question.

>hello
That's not a verb I recognise.

>examine
What do you want to examine?

>examine the clean
You can't see any such thing.

>examine the hallway
You can't see any such thing.

>examine the bathroom door
Are you kidding me....I've locked myself in..in my own bathroom. I know I left the key in here somewhere, I just need to find it.

>examine the bathroom door
Are you kidding me....I've locked myself in..in my own bathroom. I know I left the key in here somewhere, I just need to find it.

>look for hte key
You can't see any such thing.

>examine the sink
Sleek 63 inch white marble sink.  Nothing special about it.

>examine the bathtub
Who doesn't love a bubble bath :D

>examine the toilet
I should really fix this toilet, it's been clogged for a while.

>north
(first opening bathroom door)
It seems to be locked.

>north
(first opening bathroom door)
It seems to be locked.

>examine toilet
I should really fix this toilet, it's been clogged for a while.

>fix toilet
That's not a verb I recognise.

>go in toilet
That's not something you can enter.

>go toilet
That's not something you can enter.

>in toilet
I only understood you as far as wanting to (go) in.

>i want to go in you
I only understood you as far as wanting to take inventory.

>use toilet
That's not a verb I recognise.

>poop in toilet
That's not a verb I recognise.

>flush toilet
CLUNK! Lots of old toilet paper start to bubble up to the surface, and right under them is a golden key.

>examine key
You see nothing special about the gold key.

>take key
Taken.

>open door
It seems to be locked.

>use key on door
That's not a verb I recognise.

>use key
That's not a verb I recognise.

>examine door
Are you kidding me....I've locked myself in..in my own bathroom. I know I left the key in here somewhere, I just need to find it.

>unlock door
(with the gold key)
You unlock bathroom door.

>north
(first opening bathroom door)

Hallway
There's a small window on the north wall.  The bathroom is to the south, the bedroom is to the west, and the east hallway is just to the east.

You can see bathroom door here.

>examine window
I see a cat, the road, and a patch of grass

>examien cat
That's not a verb I recognise.

>examine cat
You can't see any such thing.

>get cat
You can't see any such thing.

>take cat
You can't see any such thing.

>take window
That's hardly portable.

* * *

>x bathroom
Are you kidding me....I've locked myself in..in my own bathroom. I know I left the key in here somewhere, I just need to find it.

>x toilet
I should really fix this toilet, it's been clogged for a while.

* * *

>x bathroom door
Are you kidding me....I've locked myself in..in my own bathroom. I know I left the key in here somewhere, I just need to find it.

>x bathtube
You can't see any such thing.

>x snik
You can't see any such thing.

>x sink
Sleek 63 inch white marble sink.  Nothing special.

>x bathtub
Who doesn't love a bubble bath :D

>x toilet
It's been clogged for a while.  I haven't flushed it ever since

>n
(first opening bathroom door)
It seems to be locked.

>unclog toilet
That's not a verb I recognise.

>flush toilet
You must supply a noun.

>flush toilet
You must supply a noun.

>flush the toilet
I only understood you as far as wanting to flush.

>flush
You must supply a noun.

>flush toilet
You must supply a noun.

>take
What do you want to take?

>take ke
You can't see any such thing.

>take key
Taken.

* * *

>open door
It seems to be locked.

>unlock door
(with the gold key)
Now I can finally go check my mailbox out on my lawn

>open door
That's already open.

>e
You can't go that way.

* * *

>w
You can't go that way.

>s
You can't go that way.

>n
Hallway
There's a small window on the north wall.  The living room is to the east, the bathroom is to the south, and the bedroom is to the west.

You can see bathroom door here.

* * *

>x window
I see a cat, the road, and a patch of grass

>take cat
You can't see any such thing.

>w
Bedroom
I don't really have much in my room.  I just have my bed, a study desk, and my bookshelf.  There's a wide window above the doors to my closet on the south wall.  The west hallway is just to the east.

* * *

>x bed
You see nothing special about bed.

>x desk
I haven't cleaned my study desk in a bit.  This is where I examine all of Victoria's letters, read books, do my homework

>clean desk
You rub Study desk.

>x shelf
You can't see any such thing.

>x bookshelf
A couple of books stacked together, and Victoria's favourite book, The Maze Runner

>take book
Taken.

>i
You are carrying:
  a Maze Runner Book
  a gold key

>x window
You see nothing special about wide window.

>rub desk
You rub Study desk.

>e
Hallway
There's a small window on the north wall.  The living room is to the east, the bathroom is to the south, and the bedroom is to the west.

You can see bathroom door here.

>e
Living Room
A typical living room and a square window on the east wall.  The lawn is to the north through the front door, and the east hallway is just to the west.

You can see a Front Door and Clock here.

>x windo
You can't see any such thing.

>x window
You see nothing special about square window.

>take clock
Taken.

>x clock
The hour hand broke a while back.  But at least theres a little box that tells me the date: August 25

>w
Hallway
There's a small window on the north wall.  The living room is to the east, the bathroom is to the south, and the bedroom is to the west.

You can see bathroom door here.

>e
Living Room
A typical living room and a square window on the east wall.  The lawn is to the north through the front door, and the east hallway is just to the west.

You can see a Front Door here.

* * *

>n
(first opening the Front Door)

Lawn
The sweet smell of roses drifts through the air.  The living room is just to the south through the front door.

You can see a Front Door, Mailbox and Roses here.

>take mail
You can't see any such thing.

>x roses
Victoria has always liked roses.

* * *

>take roses
They haven't bloomed yet!

>take mailbox
That's fixed in place.

>x mailbox
My favourite part of the day, checking my mailbox to see if Victoria sent me another little sketch.

Oh theres a folded piece of paper here.

* * *

>take paper
Taken.

>open mailbo
You can't see any such thing.

>open mailbox
It isn't something you can open.

>x front door
The lawn is just beyond this door.

>w
You can't go that way.

* * *

>e
You can't go that way.

>s
Living Room
A typical living room and a square window on the east wall.  The lawn is to the north through the front door, and the east hallway is just to the west.

You can see a Front Door here.

>w
Hallway
There's a small window on the north wall.  The living room is to the east, the bathroom is to the south, and the bedroom is to the west.

You can see bathroom door here.

* * *

>w
Bedroom
I don't really have much in my room.  I just have my bed, a study desk, and my bookshelf.  There's a wide window above the doors to my closet on the south wall.  The west hallway is just to the east.

>clean desk
You rub Study desk.

>x desk
I haven't cleaned my study desk in a bit.  This is where I examine all of Victoria's letters, read books, do my homework

>read paper
There's a light V.L. sketched on the corner of the paper.  This must be from Victoria.

>s
Closet
I have stacks of clothes in here, nothing really I want to get into.  My bedroom is to the south.

You can see Black tuxedo here.

>take tux
You can't see any such thing.

>take tuxedo
Taken.

>x clothes
You can't see any such thing.

>s
You can't go that way.

I beg your pardon?

I beg your pardon?

>s
You can't go that way.

>sn
That's not a verb I recognise.

I beg your pardon?

>n
Bedroom
I don't really have much in my room.  I just have my bed, a study desk, and my bookshelf.  There's a wide window above the doors to my closet on the south wall.  The west hallway is just to the east.

>wear tuxedo
After you've slipped on the jacket to the tuxedo, you look back into the closet where the tuxedo used to be, and see a doorknob.  You push the other clothes away and discover a hidden door.

>s
Closet
I have stacks of clothes in here, nothing really I want to get into.  My bedroom is to the south.

>open door
It seems to be locked.

>x doorknob
You can't see any such thing.

>open door
It seems to be locked.

>unlock door
What do you want to unlock Hidden door with?

>unlock door with key
That doesn't seem to fit the lock.

>i
You are carrying:
  Black tuxedo (being worn)
  Folded piece of paper
  Clock
  a Maze Runner Book
  a gold key

>w
You can't go that way.

* * *

>n
Bedroom
I don't really have much in my room.  I just have my bed, a study desk, and my bookshelf.  There's a wide window above the doors to my closet on the south wall.  The west hallway is just to the east.

>open desk
It isn't something you can open.

>check under bed
You can't see any such thing.

>s
Closet
I have stacks of clothes in here, nothing really I want to get into.  My bedroom is to the south.

>n
Bedroom
I don't really have much in my room.  I just have my bed, a study desk, and my bookshelf.  There's a wide window above the doors to my closet on the south wall.  The west hallway is just to the east.

>e
Hallway
There's a small window on the north wall.  The living room is to the east, the bathroom is to the south, and the bedroom is to the west.

You can see bathroom door here.

>x window
I see a cat, the road, and a patch of grass

>s
Bathroom
Squeaky clean, just how I like it.  The west hallway is just out the door to the north.

You can see bathroom door, sink, bathtub and toilet here.

>x sink
Sleek 63 inch white marble sink.  Nothing special.

* * *

>x bathtub
Who doesn't love a bubble bath :D

>go in bathtub
I should probably be trying to find a way out of the bathroom rather than chilling in there

>x
What do you want to examine?

>s
You see nothing unexpected in that direction.

>w
You can't go that way.

* * *

>e
You can't go that way.

>n
Hallway
There's a small window on the north wall.  The living room is to the east, the bathroom is to the south, and the bedroom is to the west.

You can see bathroom door here.

* * *

>w
Bedroom
I don't really have much in my room.  I just have my bed, a study desk, and my bookshelf.  There's a wide window above the doors to my closet on the south wall.  The west hallway is just to the east.

>e
Hallway
There's a small window on the north wall.  The living room is to the east, the bathroom is to the south, and the bedroom is to the west.

You can see bathroom door here.

>e
Living Room
A typical living room and a square window on the east wall.  The lawn is to the north through the front door, and the east hallway is just to the west.

You can see a Front Door here.

>x window
You see nothing special about square window.

>n
Lawn
The sweet smell of roses drifts through the air.  The living room is just to the south through the front door.

You can see a Front Door, Mailbox and Roses here.

>get roses
They haven't bloomed yet!

>open mailbox
It isn't something you can open.

>x mailbox
My favourite part of the day, checking my mailbox to see if Victoria sent me another little sketch.

>i
You are carrying:
  Black tuxedo (being worn)
  Folded piece of paper
  Clock
  a Maze Runner Book
  a gold key

>open paper
I see a sketch of a wedding arch, two rings, and a heart between two people.  Is she getting married? NO WAY.  There's also a date and time scribbled on the corner.  August 25 2:00PM.  What is the date today?  And there's another little sketch of what looks like a view from a window, there are trees, and part of a white building with a bell at the top with arrows pointing at it.

>s
Living Room
A typical living room and a square window on the east wall.  The lawn is to the north through the front door, and the east hallway is just to the west.

You can see a Front Door here.

>s
You can't go that way.

>w
Hallway
There's a small window on the north wall.  The living room is to the east, the bathroom is to the south, and the bedroom is to the west.

You can see bathroom door here.

>x window
I see a cat, the road, and a patch of grass

* * *

>s
Bathroom
Squeaky clean, just how I like it.  The west hallway is just out the door to the north.

You can see bathroom door, sink, bathtub and toilet here.

>n
Hallway
There's a small window on the north wall.  The living room is to the east, the bathroom is to the south, and the bedroom is to the west.

You can see bathroom door here.

* * *

>w
Bedroom
I don't really have much in my room.  I just have my bed, a study desk, and my bookshelf.  There's a wide window above the doors to my closet on the south wall.  The west hallway is just to the east.

>x windw
You can't see any such thing.

>x window
You see nothing special about wide window.

>x wide window
You see nothing special about wide window.

>s
Closet
I have stacks of clothes in here, nothing really I want to get into.  My bedroom is to the south.

>w
You can't go that way.

* * *

>n
Bedroom
I don't really have much in my room.  I just have my bed, a study desk, and my bookshelf.  There's a wide window above the doors to my closet on the south wall.  The west hallway is just to the east.

>open boo
You can't see any such thing.

>open book
It turns out to be a hollowed out book...and there's a mysterious silver key inside..

>take key
(the gold key)
You already have that.

* * *

>take silver key
Taken.

>s
Closet
I have stacks of clothes in here, nothing really I want to get into.  My bedroom is to the south.

>s
You can't go that way.

* * *

>e
You can't go that way.

>open door
It seems to be locked.

>unlock door with silver key
You unlock Hidden door.

>open door
After opening the hidden door, you see stairs leading down into the darkness.

>d
Underground tunnel
It is pitch dark, and you can't see a thing.  But you can hear something...

>d
You can't go that way.

>i
You are carrying:
  Silver key
  Black tuxedo (being worn)
  Folded piece of paper
  Clock
  a Maze Runner Book
  a gold key

>listen
WOOF WOOF! That sounds a lot like Victoria's dog, Chewy!

>find doog
That's not a verb I recognise.

>find dog
That's not a verb I recognise.

>listen
WOOF WOOF! That sounds a lot like Victoria's dog, Chewy!

>d
You can't go that way.

>w
You can't go that way.

>s
Darkness
It is pitch dark, and you can't see a thing.

>s
You can't go that way.

>w
You can't go that way.

>n
That's where you just came from

>e
Darkness
It is pitch dark, and you can't see a thing.

>n
Darkness
It is pitch dark, and you can't see a thing.

* * *

>w
You can't go that way.

>s
That's where you just came from

>en
That's not a verb I recognise.

>e
Darkness
It is pitch dark, and you can't see a thing.

>u
You can't go that way.

>d
You can't go that way.

* * *

>i
You are carrying:
  Silver key
  Black tuxedo (being worn)
  Folded piece of paper
  Clock
  a Maze Runner Book
  a gold key

>s
Darkness
It is pitch dark, and you can't see a thing.

>w
Darkness
It is pitch dark, and you can't see a thing.

>e
Darkness
It is pitch dark, and you can't see a thing.

* * *

>n
Darkness
It is pitch dark, and you can't see a thing.

>u
You can't go that way.

* * *

>d
You can't go that way.

>x dog
You can't see any such thing.

>listen
I can hear the bell on Chewy's collar! This is definitely the right direction

>s
Darkness
It is pitch dark, and you can't see a thing.

* * *

>s
You can't go that way.

>listen
I should go back, I can barely hear his barks

>n
Darkness
It is pitch dark, and you can't see a thing.

>listen
I can hear the bell on Chewy's collar! This is definitely the right direction

* * *

>e
Darkness
It is pitch dark, and you can't see a thing.

>listen
I see a light just to the north, and there's Chewy wagging her tail!

>x chewy
You can't see any such thing.

>n
East side of underground tunnel
As you approach Chewy, she runs up the stairs.

>u
Back room of a church
A fancy old wooden table with some candles on it.

You can see wooden door here.

>take candles
That's hardly portable.

>x candles
They're hot, probably shouldn't touch them

>open door
As you open the door, there she is.  The love of your life standing right before you, in her gorgeous wedding gown.  All you need to do is go in kiss her.

* * *

>kiss her
I'm not sure what 'her' refers to.

>kiss victoria
You can't see any such thing.

>u
You can't go that way.

>s
You can't go that way.

>n
You can't go that way.

* * *

>x bathroom door
Are you kidding me....I've locked myself in..in my own bathroom. I know I left the key in here somewhere, I just need to find it.

>x sink
Sleek 63 inch white marble sink.  Nothing special.

* * *

>x toilet
It's been clogged for a while.  I haven't flushed it ever since

>flush toilet
CLUNK! Lots of old toilet paper start to bubble up to the surface, and right under them is a gold key.

>x gold key
This is the key that unlocks the bathroom door!

>take key
Taken.

* * *

>x bathtub
Who doesn't love a bubble bath :D

>x bathroom door
Are you kidding me....I've locked myself in..in my own bathroom. I know I left the key in here somewhere, I just need to find it.

>x sink
Sleek 63 inch white marble sink.  Nothing special about it.

>x toilet
I should really fix this toilet, it's been clogged for a while.

>fix toilet
That's not a verb I recognise.

>flush toilet
CLUNK! Lots of old toilet paper start to bubble up to the surface, and right under them is a golden key.

* * *

>x paper
You can't see any such thing.

>n
(first opening bathroom door)
It seems to be locked.

* * *

>take paper
Taken.

>x paper
There's a light V.L. sketched on the corner of the paper.  This must be from Victoria.

>unfold paper
I see a sketch of a wedding arch, two rings, and a heart between two people.  There's also a date and time scribbled on the corner.  August 25 2:00PM.  And theres another little sketch of what looks like a view from a window, there are trees, and part of a white building with a bell at the top?

* * *

>x toilet
It's been clogged for a while.  I haven't flushed it ever since

>flush toilet
You must supply a noun.

>take key
Taken.

>unlock door
(with the gold key)
You unlock Bathroom door.

>n
(first opening Bathroom door)

West Hallway
The bathroom is to the south, the bedroom is to the west, and the east hallway is just to the east.

You can see Bathroom door here.

>w
Bedroom
The west hallway is just to the east.

>n
Closet
You can see Hidden door here.